8
8
ㅤ▩▩▩▩▩ㅤㅤ
ㅤ▩★ㅤ▩▩▩ㅤ
ㅤ▩ㅤ●ㅤㅤ▩ㅤ
▩▩▩ㅤ▩ㅤ▩▩
▩◆▩ㅤ▩ㅤㅤ▩
▩◆●ㅤㅤ▩ㅤ▩
▩◆ㅤㅤㅤ●ㅤ▩
▩▩▩▩▩▩▩▩