9
9
▩▩▩▩▩ㅤㅤㅤㅤ
▩★ㅤㅤ▩ㅤㅤㅤㅤ
▩ㅤ●●▩ㅤ▩▩▩
▩ㅤ●ㅤ▩ㅤ▩◆▩
▩▩▩ㅤ▩▩▩◆▩
ㅤ▩▩ㅤㅤㅤㅤ◆▩
ㅤ▩ㅤㅤㅤ▩ㅤㅤ▩
ㅤ▩ㅤㅤㅤ▩▩▩▩
ㅤ▩▩▩▩▩ㅤㅤㅤ