10
7ㅤㅤㅤ
ㅤ▩▩▩▩▩▩▩ㅤㅤ
ㅤ▩ㅤㅤㅤㅤㅤ▩▩▩
▩▩●▩▩▩ㅤㅤㅤ▩
▩ㅤ★ㅤ●ㅤㅤ●ㅤ▩
▩ㅤ◆◆▩ㅤ●ㅤ▩▩
▩▩◆◆▩ㅤㅤㅤ▩ㅤ
ㅤ▩▩▩▩▩▩▩▩ㅤ