10
7
ㅤㅤㅤ▩▩▩▩▩▩ㅤ
ㅤ▩▩▩ㅤㅤㅤㅤ▩ㅤ
▩▩◆ㅤ●▩▩ㅤ▩▩
▩◆◆●ㅤ●ㅤㅤ★▩
▩◆◆ㅤ●ㅤ●ㅤ▩▩
▩▩▩▩▩▩ㅤㅤ▩ㅤ
ㅤㅤㅤㅤㅤ▩▩▩▩ㅤ