10
8
ㅤㅤㅤ▩▩▩▩▩▩▩
ㅤㅤ▩▩ㅤㅤ▩ㅤ★▩
ㅤㅤ▩ㅤㅤㅤ▩ㅤㅤ▩
ㅤㅤ▩●ㅤ●ㅤ●ㅤ▩
ㅤㅤ▩ㅤ●▩▩ㅤㅤ▩
▩▩▩ㅤ●ㅤ▩ㅤ▩▩
▩◆◆◆◆◆ㅤㅤ▩ㅤ
▩▩▩▩▩▩▩▩▩▩