8
8
ㅤㅤ▩▩▩ㅤㅤㅤ
ㅤㅤ▩◆▩ㅤㅤㅤ
ㅤㅤ▩ㅤ▩▩▩▩
▩▩▩●ㅤ●◆▩
▩◆ㅤ●★▩▩▩
▩▩▩▩●▩ㅤㅤ
ㅤㅤㅤ▩◆▩ㅤㅤ
ㅤㅤㅤ▩▩▩ㅤㅤ